64 64
^ ^ ^ ^ ^ ^ ^ ^ ^ ^ ^ ^ ^ ^ ^ ^ ^ ^ ^ ^ ^ ^ ^ ^ ^ ^ ^ ^ ^ ^ ^ ^ ^ ^ ^ ^ ^ ^ ^ ^ ^ ^ ^ ^ ^ ^ ^ ^ ^ ^ ^ ^ ^ ^ ^ ^ ^ ^ ^ ^ ^ ^ ^ ^ 
^ ^ ^ ^ ^ ^ ^ ^ ^ ^ ^ ^ ^ ^ ^ ^ ^ . . . . . . ^ ^ ^ ^ ^ ^ ^ ^ ^ ^ ^ ^ ^ ^ ^ ^ ^ ^ . . . . . . . ^ ^ ^ ^ ^ ^ ^ ^ ^ ^ ^ ^ ^ ^ ^ ^ 
^ ^ ^ ^ ^ ^ ^ ^ ^ ^ ^ ^ . . . . . . . . . . . . . . . . . . . . . . . . . . . . . . . . . . . . . . . . ^ ^ ^ ^ ^ ^ ^ ^ ^ ^ ^ ^ 
^ ^ ^ ^ ^ ^ ^ ^ ^ . . . . . . . . . . . . . . . . . . . . . . . . . . . . . . . . . . . . . . . . . . . . ^ ^ ^ ^ ^ ^ ^ ^ ^ ^ ^ 
^ ^ ^ ^ ^ ^ ^ . . . . . . . . . . . . . . . . . . . . . . . . . . . . . . . . . . . . . . . . . . . . . . . . ^ ^ ^ ^ ^ ^ ^ ^ ^ 
^ ^ ^ ^ ^ ^ . . . . . . . . . . . . . . . . . . . . . . . . . . . . . . . . . . . . . . . . . . . . . . . . . . ^ ^ ^ ^ ^ ^ ^ ^ 
^ ^ ^ ^ ^ ^ . . . . . . . . . . . . . . . . . . . . . . . . . . . . . . . . . . . . . . . . . . . . . . . . . . . ^ ^ ^ ^ ^ ^ ^ 
^ ^ ^ ^ ^ . . . . . . . . . . . . . . . . . . . . . . . . . . . . . . . . . . . . . . . . . . . . . . . . . . . . . ^ ^ ^ ^ ^ ^ 
^ ^ ^ ^ ^ . . . . . . . . . . . . . . . . . . . . . . . . . . . . . . . . . . . . . . . . . . . . . . . . . . . . . . ^ ^ ^ ^ ^ 
^ ^ ^ ^ ^ . . . . . . . . . . . . . . . . . . . . . . . . . . . . . . . . . . . . . . . . . . . . . . . . . . . . . . ^ ^ ^ ^ ^ 
^ ^ ^ ^ ^ . . . . . . . . . . . . . . . . . . . . . . . . . ^ ^ ^ ^ ^ . . . . . . . . . . . . . . . . . . . . . . . . . ^ ^ ^ ^ 
^ ^ ^ ^ . . . . . . . . . . . . . . . . . . . . . . . . . ^ ^ ^ ^ ^ ^ ^ . . . . . . . . . . . . . . . . . . . . . . . . . ^ ^ ^ 
^ ^ ^ . . . . . . . . . . . . . . . . . . . . . . . . . ^ ^ ^ ^ ^ ^ ^ ^ ^ . . . . . . . . . . . . . . . . . . . . . . . . . . ^ 
^ ^ ^ . . . . . . . . . . . . . . . . . . . . . . . . . ^ ^ ^ ^ ^ ^ ^ ^ ^ . . . . . . . . . . . . . 2 . . . . . . . . . . . . ^ 
^ ^ ^ . . . . . . . . . . . . . . . . . . . . . . . . ^ ^ ^ ^ ^ ^ ^ ^ ^ ^ . . . . . . . . . . . . . . . . . . . . . . . . . . ^ 
^ ^ ^ . . . . . . . . . . . . . . . . . . . . . . . . ^ ^ ^ ^ ^ ^ ^ ^ ^ ^ . . . . . . . . . . . . . . . . . . . . . . . . . . ^ 
^ ^ . . . . . . . . . . . . . . . . . . . . . . . . . ^ ^ ^ ^ ^ ^ ^ ^ ^ ^ . . . . . . . . . . . . . . . . . . . . . . . . . . ^ 
^ ^ . . . . . . . . . . . . . . . . . . . . . . . . . ^ ^ ^ ^ ^ ^ ^ ^ ^ ^ . . . . . . . . . . . . . . . . . . . . . . . . . . ^ 
^ ^ . . . . . . . . . . . . . . . . . . . . * . . . . ^ ^ ^ ^ ^ ^ ^ ^ ^ . . . . . . . . . . . . . . . . . . . . . . . . . . . ^ 
^ ^ . . . . . . . . . . . . . . . . . . . . * . . . ^ ^ ^ ^ ^ ^ ^ ^ ^ ^ . . . . . . . . ^ ^ ^ . . . . . . . . . . . . . . . . ^ 
^ ^ . . . . . . . . . . . . . . . . . . . . * . . . ^ ^ ^ ^ ^ ^ ^ ^ ^ ^ . . . * . . . . ^ . ^ . . . . . . . . . . . . . . . . ^ 
^ ^ . . . . . . . . . . . . . . . . . . . * * . . . ^ ^ ^ ^ ^ ^ ^ ^ ^ ^ . . . * . . . . ^ ^ ^ . . . . . . . . . . . . . . . . ^ 
^ ^ . . . . . . . . . . . . . . . . . * * * . . . . ^ ^ ^ ^ ^ ^ ^ ^ ^ ^ . . . . * . . . . . . . . . . . . . . . . . . . . . . ^ 
^ ^ . . . . . . . . . . . . . . . . . . . . . . . . ^ ^ ^ ^ ^ ^ ^ ^ ^ ^ . . . . * * . . . . . . . . . . . . . . . . . . . . . ^ 
^ ^ . . . . . . . . . . . . . . . . . . . . . ^ ^ ^ ^ ^ ^ ^ ^ ^ ^ ^ ^ ^ . . . . . * * . . . . . . . . . . . . . . . . . . . . ^ 
^ ^ ^ . . . . . . . . . . . . . . . . . . . ^ ^ ^ ^ ^ ^ ^ ^ ^ ^ ^ ^ ^ ^ ^ . . . . . . * . . . . . . . . . . . . . . . . . . . ^ 
^ ^ ^ . . . . . . . . . . . . . . ^ ^ ^ ^ ^ ^ ^ ^ ^ ^ ^ ^ ^ ^ ^ ^ ^ ^ ^ ^ ^ . . . . . . . . . . . . . . . . . . . . . . . . ^ ^ 
^ ^ ^ . . . . . . . . . . . . ^ ^ ^ ^ ^ ^ ^ ^ ^ ^ ^ ^ ^ ^ ^ ^ ^ ^ ^ ^ ^ ^ ^ ^ . . . . ^ ^ ^ ^ ^ ^ ^ . . . . . . . . . . . . ^ ^ 
^ ^ ^ . . . . . . . . . . . ^ ^ ^ ^ ^ ^ ^ ^ ^ ^ ^ ^ ^ ^ ^ ^ ^ ^ ^ ^ ^ ^ ^ ^ ^ ^ ^ ^ ^ ^ ^ ^ ^ ^ ^ ^ ^ . . . . . . . . . . . ^ ^ 
^ ^ ^ ^ . . . . . . . . . ^ ^ ^ ^ ^ ^ ^ ^ ^ ^ ^ ^ ^ ^ ^ ^ ^ ^ ^ ^ ^ ^ ^ ^ ^ ^ ^ ^ ^ ^ ^ ^ ^ ^ ^ ^ ^ ^ ^ . . . . . . . . . . ^ ^ 
^ ^ ^ ^ . . . . . . . . ^ ^ ^ ^ ^ ^ ^ ^ ^ ^ ^ ^ ^ ^ ^ ^ ^ ^ ^ ^ ^ ^ ^ ^ ^ ^ ^ ^ ^ ^ ^ ^ ^ ^ ^ ^ ^ ^ ^ ^ . . . . . . . . . . ^ ^ 
^ ^ ^ ^ . . . . . . . . ^ ^ ^ ^ ^ ^ ^ ^ ^ ^ ^ ^ ^ ^ ^ ^ ^ ^ ^ ^ ^ ^ ^ ^ ^ ^ ^ ^ ^ ^ ^ ^ ^ ^ ^ ^ ^ ^ ^ ^ . . . . . . . . . . ^ ^ 
^ ^ ^ ^ . . . . . . . . ^ ^ ^ ^ ^ ^ ^ ^ ^ ^ ^ ^ ^ ^ ^ ^ ^ ^ ^ ^ ^ ^ ^ ^ ^ ^ ^ ^ ^ ^ ^ ^ ^ ^ ^ ^ ^ ^ ^ ^ . . . . . . . . . . ^ ^ 
^ ^ ^ ^ . . . . . . . . ^ ^ ^ ^ ^ ^ ^ ^ ^ ^ ^ ^ ^ ^ ^ ^ ^ ^ ^ ^ ^ ^ ^ ^ ^ ^ ^ ^ ^ ^ ^ ^ ^ ^ ^ ^ ^ ^ ^ ^ . . . . . . . . . . . ^ 
^ ^ ^ ^ . . . . . . . . ^ ^ ^ ^ ^ ^ ^ ^ ^ ^ ^ ^ ^ ^ ^ ^ ^ ^ ^ ^ ^ ^ ^ ^ ^ ^ ^ ^ ^ ^ ^ ^ ^ ^ ^ ^ ^ ^ ^ . . . . . . . . . . . . ^ 
^ ^ ^ ^ . . . . . . . . . ^ ^ ^ ^ ^ ^ ^ ^ ^ ^ ^ ^ ^ ^ ^ ^ ^ ^ ^ ^ ^ ^ ^ ^ ^ ^ ^ ^ ^ ^ ^ ^ ^ ^ ^ ^ ^ . . . . . . . . . . . . . ^ 
^ ^ ^ ^ . . . . . . . . . . ^ ^ ^ ^ ^ ^ ^ ^ ^ ^ ^ ^ ^ ^ ^ ^ ^ ^ ^ ^ ^ ^ ^ ^ ^ ^ ^ ^ ^ ^ ^ ^ . . . . . . . . . . . . . . . . . ^ 
^ ^ ^ ^ . . . . . . . . . . . . . . . . . . . ^ ^ ^ ^ ^ ^ ^ ^ ^ ^ ^ ^ ^ ^ ^ ^ ^ ^ ^ ^ . . . . . . . . . . . . . . . . . . . . ^ 
^ ^ ^ ^ . . . . . . . . . . . . . . . . . . . . . ^ ^ ^ ^ ^ ^ ^ ^ ^ ^ ^ ^ ^ ^ ^ ^ ^ . . . . . . . . . . . . . . . . . . . . ^ ^ 
^ ^ ^ ^ . . . . . . . . . . . . . . . * * . . . . . . . ^ ^ ^ ^ ^ ^ ^ ^ ^ ^ ^ ^ ^ . . . * . . . . . . . . . . . . . . . . . ^ ^ 
^ ^ ^ ^ . . . . . . . . . . . . . . * . . * . . . . . . . ^ ^ ^ ^ ^ ^ ^ ^ ^ . . . . . * . . . . . . . . . . . . . . . . . ^ ^ ^ 
^ ^ ^ ^ . . . . . . . . . . . . . . . . . . . * * . . . . ^ ^ ^ ^ ^ ^ ^ ^ ^ . . . * * . . . . . . . . . . . . . . . . . . . ^ ^ 
^ ^ ^ . . . . . . . . . . . . . . . . . . . . . * . . . ^ ^ ^ ^ ^ ^ ^ ^ ^ ^ . . * * . . . . . . . . . . . . . . . . . . . . ^ ^ 
^ ^ ^ . . . . . . . . . . . . . . . . . . . . . * . . ^ ^ ^ ^ ^ ^ ^ ^ ^ ^ ^ . . . . . . . . . . . . . . . . . . . . . . . . ^ ^ 
^ ^ ^ . . . . . . . . . . . . . . . . . . . . . . . . ^ ^ ^ ^ ^ ^ ^ ^ ^ ^ ^ . * * . . . . . . . . . . . . . . . . . . . . . ^ ^ 
^ ^ ^ . . . . . . . . . . . . . . . . . . . . . . . . ^ ^ ^ ^ ^ ^ ^ ^ ^ ^ . . . . . . . . . . . . . . . . . . . . . . . . . ^ ^ 
^ ^ ^ . . . . . . . . . . . . . . . . . . . . . . . . ^ ^ ^ ^ ^ ^ ^ ^ ^ ^ . . . . . . . . . . . . . . . . . . . . . . . . . ^ ^ 
^ ^ ^ . . . . . . . . . . . . . . . . . . . . . . . . ^ ^ ^ ^ ^ ^ ^ ^ ^ . . . . . . . . . . . . . . . . . . . . . . . . . . ^ ^ 
^ ^ ^ . . . . . . . . . . . . . . . . . . . . . . . . . ^ ^ ^ ^ ^ ^ ^ . . . . . . . . . . . . . . . . . . . . . . . . . . . ^ ^ 
^ ^ ^ . . . . . . . . . . . . . . . . . . . . . . . . . . ^ ^ ^ ^ ^ . . . . . . . . . . . . . . . . . . . . . . . . . . . . ^ ^ 
^ ^ ^ ^ . . . . . . . . . . . . . . . . . . . . . . . . . . . . . . . . . . . . . . . . . . . . . . . . . . . . . . . . . ^ ^ ^ 
^ ^ ^ ^ . . . . . . . . . . . . . . . . . . . . . . . . . . . . . . . . . . . . . . . . . . . . . . . . . . . . . . . . . ^ ^ ^ 
^ ^ ^ ^ . . . . . . . . . . . . . . . . . . . . . . . . . . . . . . . . . . . . . . . . . . . . . . . . . . . . . . . . . ^ ^ ^ 
^ ^ ^ ^ . . . . . . . . . . . . . . . . . . . . . . . . . . . . . . . . . . . . . . . . . . . . . . . . . . . . . . . . ^ ^ ^ ^ 
^ ^ ^ ^ . . . . . . . . 1 1 1 . 1 . . . . . . . . . . . . . . . . . . . . . . . . . . . . . . . . . . . . . . . . . . . ^ ^ ^ ^ 
^ ^ ^ ^ . . . . . . . . 1 . 1 . . . . . . . . . . . . . ^ ^ ^ ^ ^ . . . . . . . . . . . . . . . . . . . . . . . . . . ^ ^ ^ ^ ^ 
^ ^ ^ ^ ^ . . . . . . . 1 1 1 . . . . . . . . . . . ^ ^ ^ ^ ^ ^ ^ ^ . . . . . . . . . . . . . . . . . . . . . . . . ^ ^ ^ ^ ^ ^ 
^ ^ ^ ^ ^ ^ . . . . . . . . . . . . . . . . . . . ^ ^ ^ ^ ^ ^ ^ ^ ^ ^ ^ . . . . . . . . . . . . . . . . . . . . . . ^ ^ ^ ^ ^ ^ 
^ ^ ^ ^ ^ ^ ^ . . . . . . . . . . . . . . . . ^ ^ ^ ^ ^ ^ ^ ^ ^ ^ ^ ^ ^ ^ . . . . . . . . . . . . . . . . . . . . ^ ^ ^ ^ ^ ^ ^ 
^ ^ ^ ^ ^ ^ ^ ^ ^ . . . . . . . . . . . . . ^ ^ ^ ^ ^ ^ ^ ^ ^ ^ ^ ^ ^ ^ ^ ^ ^ ^ ^ . . . . . . . . . . . . . . . ^ ^ ^ ^ ^ ^ ^ ^ 
^ ^ ^ ^ ^ ^ ^ ^ ^ ^ ^ . . . . . . . . ^ ^ ^ ^ ^ ^ ^ ^ ^ ^ ^ ^ ^ ^ ^ ^ ^ ^ ^ ^ ^ ^ ^ ^ ^ . . . . . . . . . . ^ ^ ^ ^ ^ ^ ^ ^ ^ ^ 
^ ^ ^ ^ ^ ^ ^ ^ ^ ^ ^ ^ ^ ^ ^ ^ ^ ^ ^ ^ ^ ^ ^ ^ ^ ^ ^ ^ ^ ^ ^ ^ ^ ^ ^ ^ ^ ^ ^ ^ ^ ^ ^ ^ ^ ^ ^ ^ ^ ^ ^ ^ ^ ^ ^ ^ ^ ^ ^ ^ ^ ^ ^ ^ 
^ ^ ^ ^ ^ ^ ^ ^ ^ ^ ^ ^ ^ ^ ^ ^ ^ ^ ^ ^ ^ ^ ^ ^ ^ ^ ^ ^ ^ ^ ^ ^ ^ ^ ^ ^ ^ ^ ^ ^ ^ ^ ^ ^ ^ ^ ^ ^ ^ ^ ^ ^ ^ ^ ^ ^ ^ ^ ^ ^ ^ ^ ^ ^ 
^ ^ ^ ^ ^ ^ ^ ^ ^ ^ ^ ^ ^ ^ ^ ^ ^ ^ ^ ^ ^ ^ ^ ^ ^ ^ ^ ^ ^ ^ ^ ^ ^ ^ ^ ^ ^ ^ ^ ^ ^ ^ ^ ^ ^ ^ ^ ^ ^ ^ ^ ^ ^ ^ ^ ^ ^ ^ ^ ^ ^ ^ ^ ^ 
