100 100
^ ^ ^ ^ ^ ^ ^ ^ ^ . . ^ ^ ^ ^ ^ ^ ^ ^ ^ . . ^ ^ ^ ^ ^ ^ ^ ^ ^ . . . . ^ . . . . . . . . . . . . . . . . . . . . . . . . . . . . ^ . . . . ^ ^ ^ ^ ^ ^ ^ ^ ^ . . ^ ^ ^ ^ ^ ^ ^ ^ ^ . . ^ ^ ^ ^ ^ ^ ^ ^ ^ 
^ ^ ^ ^ ^ ^ ^ ^ ^ ^ ^ ^ ^ ^ ^ ^ ^ ^ ^ ^ ^ ^ ^ ^ ^ ^ ^ ^ ^ ^ ^ ^ . ^ ^ ^ ^ ^ . . . . . . . . . . . . . . . . . . . . . . . . ^ ^ ^ ^ ^ . ^ ^ ^ ^ ^ ^ ^ ^ ^ ^ ^ ^ ^ ^ ^ ^ ^ ^ ^ ^ ^ ^ ^ ^ ^ ^ ^ ^ ^ ^ ^ ^ 
^ ^ ^ ^ ^ ^ ^ ^ ^ ^ ^ ^ ^ ^ ^ ^ ^ ^ ^ ^ ^ ^ ^ ^ ^ ^ ^ ^ ^ ^ ^ ^ . ^ ^ ^ ^ ^ . . . . . . . . . . . . . . . . . . . . . . . . ^ ^ ^ ^ ^ . ^ ^ ^ ^ ^ ^ ^ ^ ^ ^ ^ ^ ^ ^ ^ ^ ^ ^ ^ ^ ^ ^ ^ ^ ^ ^ ^ ^ ^ ^ ^ ^ 
^ ^ ^ ^ ^ ^ ^ ^ ^ ^ ^ ^ ^ ^ ^ ^ ^ ^ ^ ^ ^ ^ ^ ^ ^ ^ ^ ^ ^ ^ ^ ^ ^ ^ ^ ^ ^ ^ ^ . . . . . . . . . . . . . . . . . . . . . . ^ ^ ^ ^ ^ ^ ^ ^ ^ ^ ^ ^ ^ ^ ^ ^ ^ ^ ^ ^ ^ ^ ^ ^ ^ ^ ^ ^ ^ ^ ^ ^ ^ ^ ^ ^ ^ ^ ^ 
^ ^ ^ ^ ^ ^ ^ ^ ^ ^ ^ ^ ^ ^ ^ ^ ^ ^ ^ ^ ^ ^ ^ ^ ^ ^ ^ ^ ^ ^ ^ ^ . ^ ^ ^ ^ ^ . . . . . . . . . . . . . . . . . . . . . . . . ^ ^ ^ ^ ^ . ^ ^ ^ ^ ^ ^ ^ ^ ^ ^ ^ ^ ^ ^ ^ ^ ^ ^ ^ ^ ^ ^ ^ ^ ^ ^ ^ ^ ^ ^ ^ ^ 
^ ^ ^ ^ ^ ^ ^ ^ ^ ^ ^ ^ ^ ^ ^ ^ ^ ^ ^ ^ ^ ^ ^ ^ ^ ^ ^ ^ ^ ^ ^ ^ . ^ ^ ^ ^ ^ . . . . . . . . . . . . . . . . . . . . . . . . ^ ^ ^ ^ ^ . ^ ^ ^ ^ ^ ^ ^ ^ ^ ^ ^ ^ ^ ^ ^ ^ ^ ^ ^ ^ ^ ^ ^ ^ ^ ^ ^ ^ ^ ^ ^ ^ 
^ ^ ^ ^ ^ ^ ^ ^ ^ ^ ^ ^ ^ ^ ^ ^ ^ ^ ^ ^ ^ ^ ^ ^ ^ ^ ^ ^ ^ ^ ^ ^ . . . ^ . . . . . . . . . . . . . . . . . . . . . . . . . . . . ^ . . . ^ ^ ^ ^ ^ ^ ^ ^ ^ ^ ^ ^ ^ ^ ^ ^ ^ ^ ^ ^ ^ ^ ^ ^ ^ ^ ^ ^ ^ ^ ^ ^ 
^ ^ ^ ^ ^ ^ ^ ^ ^ ^ ^ ^ ^ ^ ^ ^ ^ ^ ^ ^ ^ ^ ^ ^ ^ ^ ^ ^ ^ ^ ^ ^ . . . . . . . . . . . . . . . . . . . . . . . . . . . . . . . . . . . . ^ ^ ^ ^ ^ ^ ^ ^ ^ ^ ^ ^ ^ ^ ^ ^ ^ ^ ^ ^ ^ ^ ^ ^ ^ ^ ^ ^ ^ ^ ^ ^ 
^ ^ ^ ^ ^ ^ ^ ^ ^ . . ^ ^ ^ ^ ^ ^ ^ ^ ^ . . ^ ^ ^ ^ ^ ^ ^ ^ ^ . . . . . . . . . . . . . . . . . . . . . . . . . . . . . . . . . . . . . . ^ ^ ^ ^ ^ ^ ^ ^ ^ . . ^ ^ ^ ^ ^ ^ ^ ^ ^ . . ^ ^ ^ ^ ^ ^ ^ ^ ^ 
. ^ ^ ^ ^ ^ ^ ^ . . . . ^ ^ ^ ^ ^ ^ ^ . . . . ^ ^ ^ ^ ^ ^ ^ . . . . . . . . . . . . . . . . . . . . . . . . . . . . . . . . . . . . . . . . ^ ^ ^ ^ ^ ^ ^ . . . . ^ ^ ^ ^ ^ ^ ^ . . . . ^ ^ ^ ^ ^ ^ ^ . 
. ^ ^ ^ ^ ^ ^ ^ . . . . . . . . . . . . . . . . . . . . . . . . . . . . . . . . . . . . . . . . . . . . . . . . . . . . . . . . . . . . . . . . . . . . . . . . . . . . . . . . . . . . ^ ^ ^ ^ ^ ^ ^ . 
^ ^ ^ ^ ^ ^ ^ ^ ^ . . . . . . . . . . . . . . . . . . . . . . . . . . . . . . . . . . . . . . . . . . . . . . . . . . . . . . . . . . . . . . . . . . . . . . . . . . . . . . . . . . ^ ^ ^ ^ ^ ^ ^ ^ ^ 
^ ^ ^ ^ ^ ^ ^ ^ ^ ^ . . * * . * . * * . * . . . . . . . . . . . . . . . . . . . . . . . . . . . . . . . . . . . . . . . . . . . . . . . . . . . . . . . . . . * . * * . * . * * . . ^ ^ ^ ^ ^ ^ ^ ^ ^ ^ 
^ ^ ^ ^ ^ ^ ^ ^ ^ ^ . . * . . . . . * . . . . . . . . . . . . . . . . . . . . . . . . . . . . . . . . . . . . . . . . . . . . . . . . . . . . . . . . . . . . . . * . . . . . * . . ^ ^ ^ ^ ^ ^ ^ ^ ^ ^ 
^ ^ ^ ^ ^ ^ ^ ^ ^ ^ . . . . * * . . . . . . . . . . . . . . . . . . . . . . . . . . . . . . . . . . . . . . . . . . . . . . . . . . . . . . . . . . . . . . . . . . . . * * . . . . ^ ^ ^ ^ ^ ^ ^ ^ ^ ^ 
^ ^ ^ ^ ^ ^ ^ ^ ^ ^ . . * . * . . . . . . . . . . . . . . . . . . . . . . . . . . . . . . . . . . . . . . . . . . . . . . . . . . . . . . . . . . . . . . . . . . . . . . * . * . . ^ ^ ^ ^ ^ ^ ^ ^ ^ ^ 
^ ^ ^ ^ ^ ^ ^ ^ ^ ^ . . . . . . . . . . . . . . . . . . . . . . . . . . . . . . . . . . . . . . . . . . . . . . . . . . . . . . . . . . . . . . . . . . . . . . . . . . . . . . . . ^ ^ ^ ^ ^ ^ ^ ^ ^ ^ 
^ ^ ^ ^ ^ ^ ^ ^ ^ ^ . . * . . . . . . . . . . . . . . . . . . . . . . . . . . . . . . . . . . . . . . . . . . . . . . . . . . . . . . . . . . . . . . . . . . . . . 2 . . . . * . . ^ ^ ^ ^ ^ ^ ^ ^ ^ ^ 
^ ^ ^ ^ ^ ^ ^ ^ ^ ^ . . * * . . . . . . . . . . . . . . . . . . . . . . . . . . . . . . . . . . . . . . . . . . . . . . . . . . . . . . . . . . . . . . . . . . . . . . . . * * . . ^ ^ ^ ^ ^ ^ ^ ^ ^ ^ 
^ ^ ^ ^ ^ ^ ^ ^ ^ . . . . . . . . . . . . . . . . . . . . . . . . . . . . . ^ . . . . . . . . . . . . . . . . . . . . . . . . . . . . . . . . . . . . . . . . . . . . . . . . . . . . ^ ^ ^ ^ ^ ^ ^ ^ ^ 
. ^ ^ ^ ^ ^ ^ ^ . . . . * . . . . . . . . . . . . . . . . . . . . . . . ^ ^ ^ ^ ^ . . . . . # # # # # # # # . . . . . . . . . . . . . . . . . . . . . . . . . . . . . . . . . * . . . . ^ ^ ^ ^ ^ ^ ^ . 
. ^ ^ ^ ^ ^ ^ ^ . . . . . . . . . . . . . . . . . . . . . . . . . . . . ^ ^ ^ ^ ^ . . . . # # # # # # # # # # . . . . . . . . . . . . . . . . . . . . . . . . . . . . . . . . . . . . . ^ ^ ^ ^ ^ ^ ^ . 
^ ^ ^ ^ ^ ^ ^ ^ ^ . . . . . . . . . . . . . . . . . . . . . . . . . . ^ ^ ^ ^ ^ ^ ^ . . # # # # # # # # # # # # . . . . . . . . . . . . . . . . . . . . . . . . . . . . . . . . . . . ^ ^ ^ ^ ^ ^ ^ ^ ^ 
^ ^ ^ ^ ^ ^ ^ ^ ^ ^ . . . . . . . . . . . . . . . . . . . . . . . . . . ^ ^ ^ ^ ^ . . . # # # # # # # # # # # # . . . . . . . . . . . . . . . . . . . . . . . . . . . . . . . . . . ^ ^ ^ ^ ^ ^ ^ ^ ^ ^ 
^ ^ ^ ^ ^ ^ ^ ^ ^ ^ . . . . . . . . . . . . . . . . . . . . . . . . . . ^ ^ ^ ^ ^ . . . # # # # # # # # # # # # . . . . . . . . . . . . . . . . . . . . . . . . . . . . . . . . . . ^ ^ ^ ^ ^ ^ ^ ^ ^ ^ 
^ ^ ^ ^ ^ ^ ^ ^ ^ ^ . . . . . . . . . . . . . . . . . . . . . . . . . . ^ ^ ^ ^ ^ . . . # # # # # # # # # # # # . . . . ^ . . . . . . . . . . . . . . . . . . . . . . . . . . . . . ^ ^ ^ ^ ^ ^ ^ ^ ^ ^ 
^ ^ ^ ^ ^ ^ ^ ^ ^ ^ . . . . . . . . . . . . . . . . . . . . . . . . . . ^ ^ ^ ^ ^ . . . # # # # # # # # # # # # . . ^ ^ ^ ^ ^ . . . . . . . . . . . . . . . . . . . . . . . . . . . ^ ^ ^ ^ ^ ^ ^ ^ ^ ^ 
^ ^ ^ ^ ^ ^ ^ ^ ^ ^ . . . . . . . . . . . . . . . . . . . . . . . . . ^ ^ ^ ^ ^ ^ ^ . . # # # # # # # # # # # # . . ^ ^ ^ ^ ^ . . . . . . . . . . . . . . . . . . . . . . . . . . . ^ ^ ^ ^ ^ ^ ^ ^ ^ ^ 
^ ^ ^ ^ ^ ^ ^ ^ ^ ^ . . . . . . . . . . . . . . . . . . . . . . . . . . ^ ^ ^ ^ ^ . . . # # # # # # # # # # # # . ^ ^ ^ ^ ^ ^ ^ . . . . . . . . . . . . . . . . . . . . . . . . . . ^ ^ ^ ^ ^ ^ ^ ^ ^ ^ 
^ ^ ^ ^ ^ ^ ^ ^ ^ ^ . . . . . . . . . . . . . . . . . . . . . . . . . . ^ ^ ^ ^ ^ . . . # # # # # # # # # # # # . . ^ ^ ^ ^ ^ . . . . . . . . . . . . . . . . . . . . . . . . . . . ^ ^ ^ ^ ^ ^ ^ ^ ^ ^ 
^ ^ ^ ^ ^ ^ ^ ^ ^ . . . . . . . . . . . . . . . ^ . . . . . . . . . . . . . ^ . . . . . . # # # # # # # # # # . . . ^ ^ ^ ^ ^ . . . ^ . . . . . . . . . . . . . . . . . . . . . . . . ^ ^ ^ ^ ^ ^ ^ ^ ^ 
. ^ ^ ^ ^ ^ ^ ^ . . . . . . . . . . . . . . ^ ^ ^ ^ ^ . . . . . . . . . . . . . . . . . . . # # # # # # # # . . . . . . ^ . . . ^ ^ ^ ^ ^ . . . . . . . . . . . . . . . . . . . . . . . ^ ^ ^ ^ ^ ^ ^ . 
. . . ^ . . . . . . . . . . . . . . . . . . ^ ^ ^ ^ ^ . . . . . . . . . . . . . . . . . . . # # # # # # # # . . . . ^ ^ ^ ^ ^ . ^ ^ ^ ^ ^ . . . . . . . . . . . . . . . . . . . . . . . . . . . ^ . . . 
. ^ ^ ^ ^ ^ . . . . . . . . . . . . . . . ^ ^ ^ ^ ^ ^ ^ . . . . . . . . . . . . . . . . . # # # # # # # # # # . . . ^ ^ ^ ^ ^ ^ ^ ^ ^ ^ ^ ^ . . . . . . . . . . . . . . . . . . . . . . . . ^ ^ ^ ^ ^ . 
. ^ ^ ^ ^ ^ . . . . . . . . . . . . . . . . ^ ^ ^ ^ ^ . . . . . . . . . . . . . . * . . # # # # # # # # # # # # . ^ ^ ^ ^ ^ ^ ^ ^ ^ ^ ^ ^ . . . . . . . . . . . . . . . . . . . . . . . . . ^ ^ ^ ^ ^ . 
^ ^ ^ ^ ^ ^ ^ . . . . . . . . . . . . . . . ^ ^ ^ ^ ^ ^ . . . . . . . . . . . . . . . . # # # # # # # # # # # # . . ^ ^ ^ ^ ^ . ^ ^ ^ ^ ^ . . . . . . . . . . . . . . . . . . . . . . . . ^ ^ ^ ^ ^ ^ ^ 
. ^ ^ ^ ^ ^ . . . . . . . . . . . . . . ^ ^ ^ ^ ^ ^ ^ ^ ^ ^ . . . . . . . . . . . * . . # # # # # # # # # # # # . . ^ ^ ^ ^ ^ . . ^ ^ . . . . ^ . . . . . . . . . . . . . . . . . . . . . . ^ ^ ^ ^ ^ . 
. ^ ^ ^ ^ ^ . . . . . . . . . . . . . . ^ ^ ^ ^ ^ ^ ^ ^ ^ ^ . . . . . . . . . . . * . . # # # # # # # # # # # # . . ^ ^ ^ ^ ^ ^ ^ ^ ^ ^ . ^ ^ ^ ^ ^ . . . . . . . . . . . . . . . . . . . . ^ ^ ^ ^ ^ . 
. . . ^ . . . . . . . . . . . . . . . ^ ^ ^ ^ ^ ^ ^ ^ ^ ^ ^ ^ . . . . . . . * * . . . . # # # # # # # # # # # # . . ^ ^ ^ ^ ^ ^ ^ ^ ^ ^ . ^ ^ ^ ^ ^ . . . . . . . . . . . . . . . . . . . . . . ^ . . . 
. . . . . . . . . . . . . . . . . . . . ^ ^ ^ ^ ^ ^ ^ ^ ^ ^ . . . . . . . . * . . * . . # # # # # # # # # # # # . ^ ^ ^ ^ ^ ^ ^ ^ ^ ^ ^ ^ ^ ^ ^ ^ ^ ^ . . . . . . . . . . . . . . . . . . . . . . . . . 
. . . . . . . . . . . . . . . . . . . . ^ ^ ^ ^ ^ ^ ^ ^ ^ ^ . . . . . . . . . . * * . . # # # # # # # # # # # # . . ^ ^ ^ ^ ^ ^ ^ ^ ^ ^ . ^ ^ ^ ^ ^ . . . . . . . . . . . . . . . . . . . . . . . . . . 
. . . . . . . . . . . . . . . . . . . . . . ^ . . . . ^ . . . . . . * . * * . * * * . . # # # # # # # # # # # # . . ^ ^ ^ ^ ^ ^ ^ ^ ^ ^ . ^ ^ ^ ^ ^ . . . . . . . . . . . . . . . . . . . . . . . . . . 
. . . . . . . . . . . . . . . . . . . . . . . . . . . . . . . . . . . . . . . . . . . . . # # # # # # # # # # . . . . . ^ . . . . ^ . . . . . ^ . . . . . . . . . . . . . . . . . . . . . . . . . . . . 
. . . . . . . . . . . . . . . . ^ . . . . . . . . . . . . . . . . . . . . . . . . . . . . . # # # # # # # # . . . . . . . . . . . . . . . . . . . . . . . . . . . . . ^ . . . . . . . . . . . . . . . . 
. . . . . . . . . . . . . . ^ ^ ^ ^ ^ . . . # # # # # # # # . . . . # # # # # # # # . . . . # # # # # # # # . . . . # # # # # # # # . . . . # # # # # # # # . . . ^ ^ ^ ^ ^ . . . . . . . . . . . . . . 
. . . . . . . . . . . . . . ^ ^ ^ ^ ^ . . # # # # # # # # # # . . # # # # # # # # # # . . # # # # # # # # # # . . # # # # # # # # # # . . # # # # # # # # # # . . ^ ^ ^ ^ ^ . . . . . . . . . . . . . . 
. . . . . . . . . . ^ . . ^ ^ ^ ^ ^ ^ ^ # # # # # # # # # # # # # # # # # # # # # # # # # # # # # # # # # # # # # # # # # # # # # # # # # # # # # # # # # # # # ^ ^ ^ ^ ^ ^ ^ . . ^ . . . . . . . . . . 
. . . . . . . . ^ ^ ^ ^ ^ ^ ^ ^ ^ ^ ^ ^ # # # # # # # # # # # # # # # # # # # # # # # # # # # # # # # # # # # # # # # # # # # # # # # # # # # # # # # # # # # # ^ ^ ^ ^ ^ ^ ^ ^ ^ ^ ^ ^ . . . . . . . . 
. . . . . . . . ^ ^ ^ ^ ^ ^ ^ ^ ^ ^ ^ ^ # # # # # # # # # # # # # # # # # # # # # # # # # # # # # # # # # # # # # # # # # # # # # # # # # # # # # # # # # # # # ^ ^ ^ ^ ^ ^ ^ ^ ^ ^ ^ ^ . . . . . . . . 
. . . . . . . ^ ^ ^ ^ ^ ^ ^ ^ ^ ^ ^ ^ ^ # # # # # # # # # # # # # # # # # # # # # # # # # # # # # # # # # # # # # # # # # # # # # # # # # # # # # # # # # # # # ^ ^ ^ ^ ^ ^ ^ ^ ^ ^ ^ ^ ^ . . . . . . . 
. . . . . . . ^ ^ ^ ^ ^ ^ ^ ^ ^ ^ ^ ^ ^ # # # # # # # # # # # # # # # # # # # # # # # # # # # # # # # # # # # # # # # # # # # # # # # # # # # # # # # # # # # # ^ ^ ^ ^ ^ ^ ^ ^ ^ ^ ^ ^ ^ . . . . . . . 
. . . . . . . . ^ ^ ^ ^ ^ ^ ^ ^ ^ ^ ^ ^ # # # # # # # # # # # # # # # # # # # # # # # # # # # # # # # # # # # # # # # # # # # # # # # # # # # # # # # # # # # # ^ ^ ^ ^ ^ ^ ^ ^ ^ ^ ^ ^ . . . . . . . . 
. . . . . . . . ^ ^ ^ ^ ^ ^ ^ ^ ^ ^ ^ ^ # # # # # # # # # # # # # # # # # # # # # # # # # # # # # # # # # # # # # # # # # # # # # # # # # # # # # # # # # # # # ^ ^ ^ ^ ^ ^ ^ ^ ^ ^ ^ ^ . . . . . . . . 
. . . . . . . . . . ^ . . ^ ^ ^ ^ ^ ^ ^ # # # # # # # # # # # # # # # # # # # # # # # # # # # # # # # # # # # # # # # # # # # # # # # # # # # # # # # # # # # # ^ ^ ^ ^ ^ ^ ^ . . ^ . . . . . . . . . . 
. . . . . . . . . . . . . . ^ ^ ^ ^ ^ . . # # # # # # # # # # . . # # # # # # # # # # . . # # # # # # # # # # . . # # # # # # # # # # . . # # # # # # # # # # . . ^ ^ ^ ^ ^ . . . . . . . . . . . . . . 
. . . . . . . . . . . . . . ^ ^ ^ ^ ^ . . . # # # # # # # # . . . . # # # # # # # # . . . . # # # # # # # # . . . . # # # # # # # # . . . . # # # # # # # # . . . ^ ^ ^ ^ ^ . . . . . . . . . . . . . . 
. . . . . . . . . . . . . . . . ^ . . . . . . . . . . . . . . . . . . . . . . . . . . . . . # # # # # # # # . . . . . . . . . . . . . . . . . . . . . . . . . . . . . ^ . . . . . . . . . . . . . . . . 
. . . . . . . . . . . . . . . . . . . . . . . . . . . . ^ . . . . . ^ . . . . ^ . . . . . # # # # # # # # # # . . . . . . . . . . . . . . . . . . . . . . . . . . . . . . . . . . . . . . . . . . . . . 
. . . . . . . . . . . . . . . . . . . . . . . . . . ^ ^ ^ ^ ^ . ^ ^ ^ ^ ^ ^ ^ ^ ^ ^ . . # # # # # # # # # # # # . . * * * . * * . * . . . . . . ^ . . . . ^ . . . . . . . . . . . . . . . . . . . . . . 
. . . . . . . . . . . . . . . . . . . . . . . . . . ^ ^ ^ ^ ^ . ^ ^ ^ ^ ^ ^ ^ ^ ^ ^ . . # # # # # # # # # # # # . . * * . . . . . . . . . . ^ ^ ^ ^ ^ ^ ^ ^ ^ ^ . . . . . . . . . . . . . . . . . . . . 
. . . . . . . . . . . . . . . . . . . . . . . . . ^ ^ ^ ^ ^ ^ ^ ^ ^ ^ ^ ^ ^ ^ ^ ^ ^ ^ . # # # # # # # # # # # # . . * . . * . . . . . . . . ^ ^ ^ ^ ^ ^ ^ ^ ^ ^ . . . . . . . . . . . . . . . . . . . . 
. . . ^ . . . . . . . . . . . . . . . . . . . . . . ^ ^ ^ ^ ^ . ^ ^ ^ ^ ^ ^ ^ ^ ^ ^ . . # # # # # # # # # # # # . . . . * * . . . . . . . ^ ^ ^ ^ ^ ^ ^ ^ ^ ^ ^ ^ . . . . . . . . . . . . . . . . ^ . . 
. ^ ^ ^ ^ ^ . . . . . . . . . . . . . . . . . . . . ^ ^ ^ ^ ^ . ^ ^ ^ ^ ^ ^ ^ ^ ^ ^ . . # # # # # # # # # # # # . . * . . . . . . . . . . . ^ ^ ^ ^ ^ ^ ^ ^ ^ ^ . . . . . . . . . . . . . . . ^ ^ ^ ^ ^ 
. ^ ^ ^ ^ ^ . . . . . . . . . . . . . . . . . . . . . . ^ . . . . ^ ^ . . ^ ^ ^ ^ ^ . . # # # # # # # # # # # # . . * . . . . . . . . . . . ^ ^ ^ ^ ^ ^ ^ ^ ^ ^ . . . . . . . . . . . . . . . ^ ^ ^ ^ ^ 
^ ^ ^ ^ ^ ^ ^ . . . . . . . . . . . . . . . . . . . . . . . . ^ ^ ^ ^ ^ . ^ ^ ^ ^ ^ . . # # # # # # # # # # # # . . . . . . . . . . . . . . . . ^ . . . . ^ . . . . . . . . . . . . . . . . ^ ^ ^ ^ ^ ^ 
. ^ ^ ^ ^ ^ . . . . . . . . . . . . . . . . . . . . . . . . . ^ ^ ^ ^ ^ ^ ^ ^ ^ ^ ^ ^ . # # # # # # # # # # # # . . * . . . . . . . . . . . . . . . . . . . . . . . . . . . . . . . . . . . . ^ ^ ^ ^ ^ 
. ^ ^ ^ ^ ^ . . . . . . . . . . . . . . . . . . . . . . . . ^ ^ ^ ^ ^ ^ ^ ^ ^ ^ ^ ^ . . . # # # # # # # # # # . . . . . . . . . . . . . . . . . . . . . . . . . . . . . . . . . . . . . . . . ^ ^ ^ ^ ^ 
. . . ^ . . . . . . . . . . . . . . . . . . . . . . . . . . . ^ ^ ^ ^ ^ . ^ ^ ^ ^ ^ . . . . # # # # # # # # . . . . . . . . . . . . . . . . . . . . . . . . . . . . . . . . . . . . . . . . . . . ^ . . 
. ^ ^ ^ ^ ^ ^ ^ . . . . . . . . . . . . . . . . . . . . . . . ^ ^ ^ ^ ^ . . . ^ . . . . . . # # # # # # # # . . . . . . . . . . . . . . . . . . . . . . . . . . . . . . . . . . . . . . ^ ^ ^ ^ ^ ^ ^ . 
^ ^ ^ ^ ^ ^ ^ ^ ^ . . . . . . . . . . . . . . . . . . . . . . . . ^ . . . ^ ^ ^ ^ ^ . . . # # # # # # # # # # . . . . . . ^ . . . . . . . . . . . . . . . . . . . . . . . . . . . . . ^ ^ ^ ^ ^ ^ ^ ^ ^ 
^ ^ ^ ^ ^ ^ ^ ^ ^ ^ . . . . . . . . . . . . . . . . . . . . . . . . . . . ^ ^ ^ ^ ^ . . # # # # # # # # # # # # . . . ^ ^ ^ ^ ^ . . . . . . . . . . . . . . . . . . . . . . . . . . ^ ^ ^ ^ ^ ^ ^ ^ ^ ^ 
^ ^ ^ ^ ^ ^ ^ ^ ^ ^ . . . . . . . . . . . . . . . . . . . . . . . . . . ^ ^ ^ ^ ^ ^ ^ . # # # # # # # # # # # # . . . ^ ^ ^ ^ ^ . . . . . . . . . . . . . . . . . . . . . . . . . . ^ ^ ^ ^ ^ ^ ^ ^ ^ ^ 
^ ^ ^ ^ ^ ^ ^ ^ ^ ^ . . . . . . . . . . . . . . . . . . . . . . . . . . . ^ ^ ^ ^ ^ . . # # # # # # # # # # # # . . ^ ^ ^ ^ ^ ^ ^ . . . . . . . . . . . . . . . . . . . . . . . . . ^ ^ ^ ^ ^ ^ ^ ^ ^ ^ 
^ ^ ^ ^ ^ ^ ^ ^ ^ ^ . . . . . . . . . . . . . . . . . . . . . . . . . . . ^ ^ ^ ^ ^ . . # # # # # # # # # # # # . . . ^ ^ ^ ^ ^ . . . . . . . . . . . . . . . . . . . . . . . . . . ^ ^ ^ ^ ^ ^ ^ ^ ^ ^ 
^ ^ ^ ^ ^ ^ ^ ^ ^ ^ . . . . . . . . . . . . . . . . . . . . . . . . . . . . . ^ . . . . # # # # # # # # # # # # . . . ^ ^ ^ ^ ^ . . . . . . . . . . . . . . . . . . . . . . . . . . ^ ^ ^ ^ ^ ^ ^ ^ ^ ^ 
^ ^ ^ ^ ^ ^ ^ ^ ^ ^ . . . . . . . . . . . . . . . . . . . . . . . . . . . . . . . . . . # # # # # # # # # # # # . . . ^ ^ ^ ^ ^ . . . . . . . . . . . . . . . . . . . . . . . . . . ^ ^ ^ ^ ^ ^ ^ ^ ^ ^ 
^ ^ ^ ^ ^ ^ ^ ^ ^ ^ . . . . . . . . . . . . . . . . . . . . . . . . . . . . . . . . . . # # # # # # # # # # # # . . . ^ ^ ^ ^ ^ . . . . . . . . . . . . . . . . . . . . . . . . . . ^ ^ ^ ^ ^ ^ ^ ^ ^ ^ 
^ ^ ^ ^ ^ ^ ^ ^ ^ . . . . . . . . . . . . . . . . . . . . . . . . . . . . . . . . . . . # # # # # # # # # # # # . . ^ ^ ^ ^ ^ ^ ^ . . . . . . . . . . . . . . . . . . . . . . . . . . ^ ^ ^ ^ ^ ^ ^ ^ ^ 
. ^ ^ ^ ^ ^ ^ ^ . . . . . . . . . . . . . . . . . . . . . . . . . . . . . . . . . . . . . # # # # # # # # # # . . . . ^ ^ ^ ^ ^ . . . . . . . . . . . . . . . . . . . . . . . . . . . . ^ ^ ^ ^ ^ ^ ^ . 
. ^ ^ ^ ^ ^ ^ ^ . . . . * . . . . . . . . . . . . . . . . . . . . . . . . . . . . . . . . . # # # # # # # # . . . . . ^ ^ ^ ^ ^ . . . . . . . . . . . . . . . . . . . . . . . * . . . . ^ ^ ^ ^ ^ ^ ^ . 
^ ^ ^ ^ ^ ^ ^ ^ ^ . . . . . . . . . . . . . . . . . . . . . . . . . . . . . . . . . . . . . . . . . . . . . . . . . . . . ^ . . . . . . . . . . . . . . . . . . . . . . . . . . . . . ^ ^ ^ ^ ^ ^ ^ ^ ^ 
^ ^ ^ ^ ^ ^ ^ ^ ^ ^ . . * * . . . . . . . . . . . . . . . . . . . . . . . . . . . . . . . . . . . . . . . . . . . . . . . . . . . . . . . . . . . . . . . . . . . . . . . . * * . . ^ ^ ^ ^ ^ ^ ^ ^ ^ ^ 
^ ^ ^ ^ ^ ^ ^ ^ ^ ^ . . * . . . . 1 . . . . . . . . . . . . . . . . . . . . . . . . . . . . . . . . . . . . . . . . . . . . . . . . . . . . . . . . . . . . . . . . . . . . . * . . ^ ^ ^ ^ ^ ^ ^ ^ ^ ^ 
^ ^ ^ ^ ^ ^ ^ ^ ^ ^ . . . . . . . . . . . . . . . . . . . . . . . . . . . . . . . . . . . . . . . . . . . . . . . . . . . . . . . . . . . . . . . . . . . . . . . . . . . . . . . . ^ ^ ^ ^ ^ ^ ^ ^ ^ ^ 
^ ^ ^ ^ ^ ^ ^ ^ ^ ^ . . * . * . . . . . . . . . . . . . . . . . . . . . . . . . . . . . . . . . . . . . . . . . . . . . . . . . . . . . . . . . . . . . . . . . . . . . . * . * . . ^ ^ ^ ^ ^ ^ ^ ^ ^ ^ 
^ ^ ^ ^ ^ ^ ^ ^ ^ ^ . . . . * * . . . . . . . . . . . . . . . . . . . . . . . . . . . . . . . . . . . . . . . . . . . . . . . . . . . . . . . . . . . . . . . . . . . . * * . . . . ^ ^ ^ ^ ^ ^ ^ ^ ^ ^ 
^ ^ ^ ^ ^ ^ ^ ^ ^ ^ . . * . . . . . * . . . . . . . . . . . . . . . . . . . . . . . . . . . . . . . . . . . . . . . . . . . . . . . . . . . . . . . . . . . . . . * . . . . . * . . ^ ^ ^ ^ ^ ^ ^ ^ ^ ^ 
^ ^ ^ ^ ^ ^ ^ ^ ^ ^ . . * * . * . * * . * . . . . . . . . . . . . . . . . . . . . . . . . . . . . . . . . . . . . . . . . . . . . . . . . . . . . . . . . . . * . * * . * . * * . . ^ ^ ^ ^ ^ ^ ^ ^ ^ ^ 
^ ^ ^ ^ ^ ^ ^ ^ ^ . . . . . . . . . . . . . . . . . . . . . . . . . . . . . . . . . . . . . . . . . . . . . . . . . . . . . . . . . . . . . . . . . . . . . . . . . . . . . . . . . . ^ ^ ^ ^ ^ ^ ^ ^ ^ 
. ^ ^ ^ ^ ^ ^ ^ . . . . . . . . . . . . . . . . . . . . . . . . . . . . . . . . . . . . . . . . . . . . . . . . . . . . . . . . . . . . . . . . . . . . . . . . . . . . . . . . . . . . ^ ^ ^ ^ ^ ^ ^ . 
. ^ ^ ^ ^ ^ ^ ^ . . . . ^ ^ ^ ^ ^ ^ ^ . . . . ^ ^ ^ ^ ^ ^ ^ . . . . . . . . . . . . . . . . . . . . . . . . . . . . . . . . . . . . . . . . ^ ^ ^ ^ ^ ^ ^ . . . . ^ ^ ^ ^ ^ ^ ^ . . . . ^ ^ ^ ^ ^ ^ ^ . 
^ ^ ^ ^ ^ ^ ^ ^ ^ . . ^ ^ ^ ^ ^ ^ ^ ^ ^ . . ^ ^ ^ ^ ^ ^ ^ ^ ^ . . . . . . . . . . . . . . . . . . . . . . . . . . . . . . . . . . . . . . ^ ^ ^ ^ ^ ^ ^ ^ ^ . . ^ ^ ^ ^ ^ ^ ^ ^ ^ . . ^ ^ ^ ^ ^ ^ ^ ^ ^ 
^ ^ ^ ^ ^ ^ ^ ^ ^ ^ ^ ^ ^ ^ ^ ^ ^ ^ ^ ^ ^ ^ ^ ^ ^ ^ ^ ^ ^ ^ ^ ^ . . . . . . . . . . . . . . . . . . . . . . . . . . . . . . . . . . . . ^ ^ ^ ^ ^ ^ ^ ^ ^ ^ ^ ^ ^ ^ ^ ^ ^ ^ ^ ^ ^ ^ ^ ^ ^ ^ ^ ^ ^ ^ ^ ^ 
^ ^ ^ ^ ^ ^ ^ ^ ^ ^ ^ ^ ^ ^ ^ ^ ^ ^ ^ ^ ^ ^ ^ ^ ^ ^ ^ ^ ^ ^ ^ ^ . . . ^ . . . . . . . . . . . . . . . . . . . . . . . . . . . . ^ . . . ^ ^ ^ ^ ^ ^ ^ ^ ^ ^ ^ ^ ^ ^ ^ ^ ^ ^ ^ ^ ^ ^ ^ ^ ^ ^ ^ ^ ^ ^ ^ ^ 
^ ^ ^ ^ ^ ^ ^ ^ ^ ^ ^ ^ ^ ^ ^ ^ ^ ^ ^ ^ ^ ^ ^ ^ ^ ^ ^ ^ ^ ^ ^ ^ . ^ ^ ^ ^ ^ . . . . . . . . . . . . . . . . . . . . . . . . ^ ^ ^ ^ ^ . ^ ^ ^ ^ ^ ^ ^ ^ ^ ^ ^ ^ ^ ^ ^ ^ ^ ^ ^ ^ ^ ^ ^ ^ ^ ^ ^ ^ ^ ^ ^ ^ 
^ ^ ^ ^ ^ ^ ^ ^ ^ ^ ^ ^ ^ ^ ^ ^ ^ ^ ^ ^ ^ ^ ^ ^ ^ ^ ^ ^ ^ ^ ^ ^ . ^ ^ ^ ^ ^ . . . . . . . . . . . . . . . . . . . . . . . . ^ ^ ^ ^ ^ . ^ ^ ^ ^ ^ ^ ^ ^ ^ ^ ^ ^ ^ ^ ^ ^ ^ ^ ^ ^ ^ ^ ^ ^ ^ ^ ^ ^ ^ ^ ^ ^ 
^ ^ ^ ^ ^ ^ ^ ^ ^ ^ ^ ^ ^ ^ ^ ^ ^ ^ ^ ^ ^ ^ ^ ^ ^ ^ ^ ^ ^ ^ ^ ^ ^ ^ ^ ^ ^ ^ ^ . . . . . . . . . . . . . . . . . . . . . . ^ ^ ^ ^ ^ ^ ^ ^ ^ ^ ^ ^ ^ ^ ^ ^ ^ ^ ^ ^ ^ ^ ^ ^ ^ ^ ^ ^ ^ ^ ^ ^ ^ ^ ^ ^ ^ ^ ^ 
^ ^ ^ ^ ^ ^ ^ ^ ^ ^ ^ ^ ^ ^ ^ ^ ^ ^ ^ ^ ^ ^ ^ ^ ^ ^ ^ ^ ^ ^ ^ ^ . ^ ^ ^ ^ ^ . . . . . . . . . . . . . . . . . . . . . . . . ^ ^ ^ ^ ^ . ^ ^ ^ ^ ^ ^ ^ ^ ^ ^ ^ ^ ^ ^ ^ ^ ^ ^ ^ ^ ^ ^ ^ ^ ^ ^ ^ ^ ^ ^ ^ ^ 
^ ^ ^ ^ ^ ^ ^ ^ ^ ^ ^ ^ ^ ^ ^ ^ ^ ^ ^ ^ ^ ^ ^ ^ ^ ^ ^ ^ ^ ^ ^ ^ . ^ ^ ^ ^ ^ . . . . . . . . . . . . . . . . . . . . . . . . ^ ^ ^ ^ ^ . ^ ^ ^ ^ ^ ^ ^ ^ ^ ^ ^ ^ ^ ^ ^ ^ ^ ^ ^ ^ ^ ^ ^ ^ ^ ^ ^ ^ ^ ^ ^ ^ 
^ ^ ^ ^ ^ ^ ^ ^ ^ . . ^ ^ ^ ^ ^ ^ ^ ^ ^ . . ^ ^ ^ ^ ^ ^ ^ ^ ^ . . . . ^ . . . . . . . . . . . . . . . . . . . . . . . . . . . . ^ . . . . ^ ^ ^ ^ ^ ^ ^ ^ ^ . . ^ ^ ^ ^ ^ ^ ^ ^ ^ . . ^ ^ ^ ^ ^ ^ ^ ^ ^ 
